1111111
10P0CE1
1111011
1111011
10P0CE1
1111111
