1111111
10P0CE1
1111111
1111111
10P0CE1
1111111
