11111111111111111111111111111111
1P0000000000000E0000000000000001
10000CCCCCCC00000000000000000001
10000000000000000000000000000001
1DDDDDDDDDDDDDDDDDDDDDDDDDDDDDD1
10000000000000000000000000000001
10000000000000000000000000000001
10000000000000000000000000000001
10000000000000000000000000000001
10000000000000000000000000000001
10000000000000000000000000000001
10000000000000000000000000000001
10000000000000000000000000000001
10000000000000000000000000000001
10000000000000000000000000000001
10000000000000000000000000000001
10000000000000000000000000000001
10000000000000000000000000000001
10000000000000000000000000000001
10000000000000000000000000000001
10000000000000000000000000000001
11111111111111111111111111111111
