1111111111
1P00000001
1111110001
1D00000C01
1000000C01
1000000C01
1111110001
1000000001
1000000E01
1111111111
