00000011000000
00000100100000
00001000010000
00010000001000
00100PC0E00100
01000000000010
11111111111111
