1111111111
1P000000D1
1000CCC0E1
1111111111