111110000
10P001000
10C000100
10E000010
111111111
