1111111111
1P0C0E0001
100000001
1000000001
1111111111
